                                                    ☺☺☺☺☺☺       ☺           ☺☺ 
                                                   ☺☺☺☺☺☺☺     ☺☺ ☺           ☺☺
                       ☺☺☺☺☺☺☺☺☺                   ☺☺☺☺☺☺      ☺☺☺☺           ☺ 
                       ☺☺☺☺☺☺☺☺☺                   ☺☺☺☺☺☺      ☺☺☺☺             
          ☺☺☺       ☺☺☺☺☺☺☺☺☺☺☺☺                   ☺☺☺☺☺☺       ☺☺☺             
     ☺☺☺☺☺☺☺☺  ☺☺☺☺☺☺☺☺                             ☺☺☺☺                        
     ☺☺☺☺☺☺☺☺  ☺☺☺☺☺☺☺☺☺☺☺☺☺☺                      ☺☺☺☺                         
  ☺  ☺☺☺☺☺     ☺☺☺☺☺   ☺☺☺☺☺☺                        ☺                    ☺☺☺   
     ☺☺☺☺☺☺☺☺  ☺☺☺☺☺☺☺☺☺☺☺☺☺☺        ☺☺☺          ☺ ☺☺                    ☺☺☺   
     ☺☺☺☺☺☺☺☺  ☺☺☺☺☺☺☺☺         ☺☺☺  ☺☺☺         ☺☺☺☺☺                   ☺☺☺☺   
          ☺☺☺       ☺☺☺☺☺☺☺☺☺   ☺☺☺  ☺☺☺          ☺☺                     ☺☺☺☺   
 ☺☺☺                   ☺☺☺☺☺☺   ☺☺☺        ☺☺☺☺                           ☺☺    
 ☺☺☺                   ☺☺☺☺☺☺            ☺☺☺☺☺☺                                 
 ☺☺☺                                     ☺☺☺☺☺☺                                 
                                         ☺☺☺☺☺         ☺☺☺☺                     
     ☺☺☺☺☺     ☺☺                        ☺☺☺☺          ☺☺☺☺☺☺☺☺☺                
     ☺☺☺☺☺     ☺☺                       ☺☺☺☺            ☺☺☺☺☺☺☺☺☺   ☺☺☺         
     ☺☺☺☺☺                                               ☺☺☺☺☺☺☺☺☺☺☺ ☺☺         
     ☺☺☺☺☺                               ☺               ☺☺☺☺☺☺☺☺☺☺☺☺☺☺☺        
     ☺☺☺☺☺                             ☺☺     ☺☺☺         ☺     ☺☺☺☺☺☺☺☺        
                                       ☺☺     ☺☺☺                ☺☺☺ ☺☺☺        
                                    ☺☺☺☺     ☺☺ ☺                               
                                    ☺☺☺☺     ☺☺☺                ☺            ☺☺☺
                                  ☺☺☺☺☺                                      ☺☺☺
                                ☺☺☺☺                                        ☺☺☺☺
                              ☺☺☺☺☺☺     ☺☺                                 ☺☺☺☺
                              ☺☺☺☺☺      ☺☺                       ☺ ☺☺☺    ☺☺ ☺☺
                            ☺☺☺☺☺☺      ☺☺☺                   ☺☺    ☺☺☺☺   ☺☺☺☺☺
                           ☺☺☺☺☺☺       ☺                    ☺☺☺☺          ☺☺☺☺☺
                          ☺☺☺                                ☺☺☺          ☺☺☺☺☺☺
                          ☺☺          ☺☺                                  ☺☺☺☺☺☺
                              ☺      ☺☺☺                   ☺☺          ☺  ☺☺☺☺☺☺
                                                          ☺☺☺            ☺☺☺☺☺☺☺
                   ☺☺☺☺☺☺☺☺☺                              ☺☺☺    ☺       ☺☺☺☺☺☺☺
                  ☺☺☺☺☺☺☺☺☺       ☺                      ☺☺☺☺    ☺      ☺☺☺☺☺☺ ☺
                 ☺☺☺☺☺☺☺☺☺  ☺                            ☺☺☺☺           ☺☺☺☺☺☺☺ 
                 ☺☺☺☺☺☺☺☺☺    ☺                  ☺☺      ☺☺☺☺☺☺☺☺       ☺☺☺☺☺☺  
                ☺ ☺☺☺☺☺ ☺☺  ☺☺☺☺☺                ☺       ☺☺☺☺☺☺☺☺☺      ☺       
               ☺☺☺☺☺☺☺☺☺☺☺ ☺☺☺☺☺☺  ☺            ☺☺☺☺☺   ☺☺☺☺☺☺☺☺☺☺☺             
              ☺☺☺☺☺☺☺☺☺☺☺  ☺☺☺☺☺☺ ☺☺        ☺☺☺ ☺☺☺☺☺  ☺☺☺☺☺☺☺☺☺☺☺☺             
            ☺ ☺☺☺☺☺☺☺☺☺☺☺  ☺☺☺☺☺ ☺☺☺   ☺  ☺ ☺☺ ☺☺☺☺☺☺  ☺☺☺☺☺☺☺☺☺☺☺☺             
              ☺☺☺☺☺☺☺☺☺☺   ☺☺☺☺☺            ☺  ☺☺☺☺☺☺ ☺☺☺☺☺☺☺☺☺☺☺☺              
              ☺☺☺☺☺☺☺☺☺       ☺                ☺☺☺☺☺  ☺☺ ☺☺☺☺☺ ☺☺        ☺      
  ☺☺  ☺☺       ☺☺☺☺☺☺☺☺      ☺☺              ☺ ☺ ☺    ☺☺☺☺☺☺☺☺☺☺☺☺☺☺☺☺          
 ☺☺☺☺☺☺☺           ☺☺☺☺                        ☺      ☺☺☺☺☺☺☺☺☺☺  ☺☺ ☺☺         
☺ ☺☺☺☺☺☺           ☺☺☺☺                              ☺☺☺☺☺☺☺☺☺☺   ☺☺☺☺☺         
☺☺☺☺☺☺☺      ☺☺    ☺☺☺                              ☺☺☺☺☺☺☺☺☺      ☺☺☺    ☺    ☺
☺☺☺☺☺☺☺            ☺☺☺                               ☺                 ☺☺☺☺☺☺☺  
☺☺☺☺☺☺             ☺☺                   ☺☺☺       ☺                   ☺☺☺☺☺☺☺   
☺☺☺☺☺☺                                  ☺☺         ☺       ☺       ☺☺☺☺ ☺☺ ☺    
☺☺☺☺☺☺          ☺☺☺                                ☺☺☺☺          ☺☺☺☺☺☺☺☺☺      
☺☺☺☺☺          ☺☺☺☺                    ☺       ☺☺☺ ☺☺☺☺   ☺      ☺☺☺☺☺☺☺ ☺      
☺☺☺☺☺   ☺☺☺☺    ☺☺                   ☺☺☺      ☺☺☺☺☺ ☺☺☺         ☺☺☺☺☺☺☺☺☺☺☺     
☺☺ ☺☺    ☺☺☺                         ☺☺      ☺☺☺☺☺☺  ☺☺☺        ☺☺☺☺☺☺☺☺☺☺☺     
☺☺☺☺                                 ☺☺     ☺☺☺☺☺☺     ☺☺☺     ☺☺☺☺☺☺☺          
☺☺☺☺                                        ☺☺☺☺        ☺☺  ☺ ☺☺☺☺☺☺☺           
☺☺☺                               ☺      ☺☺☺☺☺               ☺☺☺☺☺☺☺            
☺☺☺                             ☺☺☺     ☺☺☺☺☺☺         ☺     ☺☺☺ ☺☺             
                               ☺ ☺☺     ☺☺☺☺☺               ☺  ☺                
        ☺☺☺ ☺☺☺                ☺☺☺ ☺  ☺☺☺☺☺          ☺          ☺               
        ☺☺☺☺☺☺☺☺     ☺         ☺☺☺     ☺☺☺          ☺☺☺                         
        ☺☺☺☺☺☺☺☺☺☺☺☺☺☺☺              ☺☺☺☺☺           ☺☺☺                        
         ☺☺ ☺☺☺☺☺☺☺☺☺☺☺               ☺☺    ☺☺☺       ☺☺☺☺                      
         ☺☺☺   ☺☺☺☺☺☺☺☺☺            ☺☺☺     ☺☺☺      ☺☺☺☺☺           ☺          
                ☺☺☺☺☺☺☺☺☺          ☺☺☺☺      ☺☺      ☺☺☺☺☺       ☺   ☺          
                     ☺☺☺☺         ☺☺☺☺☺             ☺☺☺☺☺☺    ☺  ☺    ☺         
                                 ☺☺☺☺☺☺            ☺☺☺☺☺☺☺            ☺ ☺       
                                 ☺☺☺☺☺☺           ☺☺☺☺☺☺☺☺          ☺   ☺       
    ☺☺                           ☺☺☺☺☺           ☺☺☺☺☺☺☺☺          ☺            
   ☺☺☺☺                     ☺☺      ☺            ☺☺☺☺☺☺☺☺      ☺  ☺   ☺☺        
   ☺☺☺☺                   ☺☺☺☺☺                 ☺☺ ☺☺☺☺☺☺☺       ☺   ☺☺☺☺☺☺     
   ☺☺☺                    ☺☺ ☺                   ☺☺☺☺☺☺☺☺       ☺☺   ☺☺☺☺☺☺     
   ☺☺☺                    ☺                ☺☺ ☺☺        ☺        ☺  ☺☺☺☺☺☺☺     
                         ☺☺☺☺          ☺☺☺☺☺☺☺☺☺☺☺☺☺                ☺ ☺☺☺☺☺     
                        ☺☺☺☺            ☺☺☺☺☺☺☺☺☺☺☺              ☺    ☺☺☺☺☺     
             ☺☺☺       ☺☺☺☺☺☺          ☺☺☺☺☺☺☺☺☺☺☺              ☺               
             ☺☺☺☺      ☺☺☺☺☺☺  ☺☺      ☺☺☺☺☺☺ ☺☺☺                               
 ☺           ☺☺☺☺      ☺☺☺☺☺☺  ☺       ☺☺☺☺☺☺☺☺☺                                
☺☺           ☺ ☺☺     ☺☺☺☺☺☺☺          ☺☺☺☺☺☺☺                                  
 ☺☺           ☺       ☺☺☺☺☺☺          ☺☺☺ ☺☺  ☺                                 
